SO                 ./textures/path_to_the_SOUTH_texture                                           






              NO                  ./textures/path_to_the_north_texture                            




                        WE                      ./textures/path_to_the_west_texture                   


          EA                       ./textures/row.xpm                                                                                          

C      255     ,        255   ,    255      


F     255     ,        255   ,    255
       
                               
                1111111111111111111111111111111111111111
                100000000110000000000000000000000000001
                1011010001110000000000000000S0000000001
                101101000111000000010100000000000000001
                1001000000000000001 10100011111111111111
        1111111110110000011110000001010001
        1000000000110000011101111111111111
        11110111111111011100000010001
        11110111111111011101010010001
        11000000110101011100000010001
        10000000000000001100000010001
        10000000000000001101010010001
        1100000111010101111101111000111
        11110111 1110101 101111010001
        11111111 1111111 111111111111